1111111111111111111111111
1000015551010011225111221
1015511511015111155522221
1111000000010000021221151
1000001515510011025321121
1011511011000050021221551
1000010001015511011222221
1115510101011011012255551
1000010001001001052252221
1111111111111111111111111
