1111111111111111111111111111
1088888888888888888888888881
1086666666666666666665556681
1086655566666666666653335681
1086555666666666666533333581
1085555555555555555333233581
1085444444444444444333335681
1072222222222222222333356681
1085444444444444444333335681
1085555555555555555333233581
1086555666666666666533333581
1086655566666666666653335681
1086666666666666666665556681
1088888888888888888888888881
1111111111111111111111111111
