1111111111111111
1010101000100521
1010000010100521
1011101110000221
1000000010100221
1323011110101521
1223000000100521
1111111111111111