1111111111111111111111111
1000000330001000000000001
1001000130101101001001001
1001010130101001001001001
1000010333100001000001001
1000010333101000001001001
1001010133101001001000001
1001000133101101001001001
1000000333001000000000001
1111111111111611111111111
