1111111111111111111111111
1000000300001000000000001
1001000100101101001001001
1001010100001001001001001
1000010000100001000001001
1000010000101000001001001
1001010100101001001000001
1001000000001101001001001
1000000003001000000000001
1111111111111611111111111
