1111111111111111111111111111
1222225522522522332224422331
1288888288888388888288888281
1286068286068586068286068281
1486668286668286668286668281
1388688288688588688288688281
1235445534422332224552255231
1233223234222352224442222221
1332222222223554422222244431
1288688288688288688288688481
1286668286668286668286668281
1586068586068286068286068281
1588888588888488888488888381
1524442222222442224422223321
1111111111111111111111111111
