1111111111111111111111111111
1222443323322300000000000001
1211311211311305555588888881
1211411411211205000586666681
1233322322222405555588666881
1311311311211400505076696681
1311211211311205555588666881
1233223422322205000586666681
1211211411311305555588666881
1211311311211300505076696681
1222322322223305555588666881
1311311211211205000586666681
1311211211311205555588888881
1443223442323300000000000001
1111111111111111111111111111
