1111111111111111111111111111
1223333322250000522233333221
1233888332250000522338883321
1338666833255555523386668331
1386666683322222233866666831
1386696668332222338666966831
1338666666833223386666668331
1233766666683333866666673321
1338666666833223386666668331
1386696668332222338666966831
1386666683322222233866666831
1338666833255555523386668331
1233888332250000522338883321
1223333322250000522233333221
1111111111111111111111111111
