1111111111111111
1010000000000101
1010000010000101
1011001110000101
1000000010100101
1001011110100101
1001000000100001
1111111111111111