1111111111111111111111111111
1000443303300300000000000001
1011311011311305555588888801
1011411411011005222286666801
1033300300000405252586116801
1311311311011405666666116701
1311011011311005252586666801
1033003400300002222286666801
1011011411311305252586666801
1011311311011305666666116701
1000300300003305252586116801
1311311011011005222286666801
1311011011311005555588888801
1443003440303300000000000001
1111111111111111111111111111
