1111111111111111
1005101055233221
1000333315122521
1050525233222551
1000222225552221
1512225522223321
1553332222222521
1111111111111111